######################################
#                               $    #
# #############         ######       #
#                                    #
# ########            #############  #
#                 @                  #
#   #######################          #
#                                    #
#                                    #
#  #############################     #
#                                    #
######################################