######################################
#                                    #
# #############         ######       #
#                                    #
# ########            #############  #
#                                    #
#   #######################          #
#                                    #
#                                    #
#  #############################     #
#                                    #
######################################